14 18
7 0
7 17
******************
**.............***
**.***********.***
**.****......*.***
**.*********.*.***
**...........*.***
**************.***
..................
************...***
************....**
************.....*
***************..*
***************...
***************...